10.lM
..l.....l.
.l.l..l...
..l.ll....
...ll..ll.
........l.
.....l.l.l
.l..l..l..
.l....l..l
..l.l...ll
.l......l.
